................................
................................
................................
................................
................................
................................
................................
................................
................................
%............................x..
................................
................................
#............................###
##..........................####
###........................#####
@@@$$$$$$$$$$$$$$$$$$$$$$$$@@@@@
@@@@@@@@@@@@@@@@@@@@@@@@@@@@@@@@
@@@@@@@@@@@@@@@@@@@@@@@@@@@@@@@@