................................
................................
................................
................................
................................
................................
................................
................................
................................
.%...........................x..
................................
................................
###..........................###
###..........................###
###..........................###
@@@$$$$$$$$$$$$$$$$$$$$$$$$$$@@@
@@@@@@@@@@@@@@@@@@@@@@@@@@@@@@@@
@@@@@@@@@@@@@@@@@@@@@@@@@@@@@@@@